1111111
1P000C1
10111E1
10000E1
1111111
