1111111
1P000C1
1011P01
10000E1
1111111
