11111111111111111111111111111111111111
10000011111111111111111111111111111111
1000C011111111111111111111111111111111
10000C00111111111111111111111111111111
11110101111000111111111111111111111111
1110C0010C0000C0C111111111111111111111
111C0111C01111000111111111111111111111
1111C000000C00001111111111111111111111
1111100C010000111111111111111111111111
11110000C00000111111111111111111111111
100C000P00C00C011111111111111111111111
10100000001101111111111111111111111111
11110010000111111111111111111111111111
1000E000010111111111111111111111111111
11000000000111111111111111111111111111
11100000011111111111111111111111111111
11110011111111111111111111111111111111
11111111111111111111111111111111111111
11111111111111111111111111111111111111
11111111111111111111111111111111111111
