111111111111111111111111
11000011111100C111111111
1000C0111110001111111111
11000C001111011111111111
111101011110001111111111
1110C0010C0000C0C1111111
111C0111C011110001111111
1111C000000C000011111111
1111100C0100001111111111
1111000000C0000011111111
100C000P00000C0100111111
101000000011011110000011
111100100001111111110011
1000E0000101111111111001
110000000000000111111101
111000000111110011110001
11110011111111000110C111
1C0110111111111100001111
10C000111111111111111111
111111111111111111111111
