1111111
1P000C1
1011101
1000001
1111111
