1111111
10000C1
1011101
10000E1
1111111
