1111111
1P000C1
101110
10000E1
1111111
