1111111
P000C11
1011101
00000E1
1111111
