1111111
1P011C1
1111101
10000E1
1111111
